+---+---+---+---+
|               |
+---+---+   +   +
|           |   |
+---+---+---+   +
|               |
+---+---+---+   +
|               |
+---+---+---+---+