+---+---+---+---+
| 5   4   5   6 |
+---+   +---+---+
| 2   3   4   5 |
+   +   +---+   +
| 1 | 4 | 7   6 |
+   +---+   +---+
| 0 | 9   8   9 |
+---+---+---+---+