+---+---+---+---+
|     4   5   6 |
+---+   +---+---+
| 2   3         |
+   +   +---+   +
| 1 |   |       |
+   +---+   +---+
| 0 |           |
+---+---+---+---+